#Sample	Index	Primer_with_index
L1Galactose1	ATACC	ACGCTCTTCCGATCTATACCGTCCACGAGGTCTCT
L1Galactose2	TCTAG	ACGCTCTTCCGATCTTCTAGGTCCACGAGGTCTCT
L1Galactose3	GCAGC	ACGCTCTTCCGATCTGCAGCGTCCACGAGGTCTCT
L1Glucose1	CCGAG	ACGCTCTTCCGATCTCCGAGGTCCACGAGGTCTCT
L1Glucose2	AAGAT	ACGCTCTTCCGATCTAAGATGTCCACGAGGTCTCT
L1Glucose3	TAGTA	ACGCTCTTCCGATCTTAGTAGTCCACGAGGTCTCT
L25Galactose1	GAACT	ACGCTCTTCCGATCTGAACTGTCCACGAGGTCTCT
L25Galactose2	CAATG	ACGCTCTTCCGATCTCAATGGTCCACGAGGTCTCT
L25Galactose3	AGACA	ACGCTCTTCCGATCTAGACAGTCCACGAGGTCTCT
L25Glucose1	TGTTC	ACGCTCTTCCGATCTTGTTCGTCCACGAGGTCTCT
L25Glucose2	GCCGG	ACGCTCTTCCGATCTGCCGGGTCCACGAGGTCTCT
L25Glucose3	CGTAG	ACGCTCTTCCGATCTCGTAGGTCCACGAGGTCTCT
S2Galactose1	ACACG	ACGCTCTTCCGATCTATACCGTCCACGAGGTCTCT
S2Galactose2	TGTAA	ACGCTCTTCCGATCTTGTAAGTCCACGAGGTCTCT
S2Galactose3	GTATT	ACGCTCTTCCGATCTGTATTGTCCACGAGGTCTCT
S2Glucose1	CTCTA	ACGCTCTTCCGATCTCTCTAGTCCACGAGGTCTCT
S2Glucose2	AAGGC	ACGCTCTTCCGATCTAAGGCGTCCACGAGGTCTCT
S2Glucose3	TTAAG	ACGCTCTTCCGATCTTTAAGGTCCACGAGGTCTCT
S15Galactose1	GGAAC	ACGCTCTTCCGATCTGGAACGTCCACGAGGTCTCT
S15Galactose2	CTCAG	ACGCTCTTCCGATCTCTCAGGTCCACGAGGTCTCT
S15Galactose3	ACTGG	ACGCTCTTCCGATCTACTGGGTCCACGAGGTCTCT
S15Glucose1	TACAT	ACGCTCTTCCGATCTTACATGTCCACGAGGTCTCT
S15Glucose2	GGCAT	ACGCTCTTCCGATCTGGCATGTCCACGAGGTCTCT
S15Glucose3	CAGTT	ACGCTCTTCCGATCTCAGTTGTCCACGAGGTCTCT
Bet1Galactose1	ACCAG	ACGCTCTTCCGATCTATACCGTCCACGAGGTCTCT
Bet1Galactose2	TTAGC	ACGCTCTTCCGATCTTTAGCGTCCACGAGGTCTCT
Bet1Galactose3	GCCAC	ACGCTCTTCCGATCTGCCACGTCCACGAGGTCTCT
Bet1Glucose1	CGACC	ACGCTCTTCCGATCTCGACCGTCCACGAGGTCTCT
Bet1Glucose2	ATTAG	ACGCTCTTCCGATCTATTAGGTCCACGAGGTCTCT
Bet1Glucose3	TTCTT	ACGCTCTTCCGATCTTTCTTGTCCACGAGGTCTCT
